10 8
0 -3 0 -3 0 -3 0 -3 -3 0
0 7 -2 3 -2 2 -2 3 11 0
0 -7 -2 -2 -2 -2 2 -2 2 -2
0 6 -2 -2 -2 -2 -2 2 -2 -2
0 -7 -2 -2 -2 -2 2 -2 2 -2
0 8 -2 -2 -2 -2 -2 2 -2 -2
0 -7 -2 -2 -2 -2 2 -2 2 -2
0 -3 0 0 0 0 0 0 0 0
1
8 0 TOP
2
9 2 RIGHT 1
9 3 RIGHT 2
